1111111111111
1C010000000C1
1C00011111C11
1P0C11E000011
1111111111111