1111111111111
1C010000000W1
1W00011111C11
1P0W11E000011
1111111111111