11111111111111111111
1C1C1011110000000011
10W0WC0000011W1W1C11
100000101101W101W1C1
10101110110000W000C1
10100010111111111111
101010100000000000C1
1011101111100001W0C1
10101011C1W1111100C1
1E1P00110000000000C1
11111111111111111111