1111111111111111111111111111111111
1E00C0000C10000C00C00C000000000001
10100101W1100000101001000W00010101
1010010010101010001001000000010101
1P0000000C00C00000C000000W000000C1
1111111111111111111111111111111111