11111111111111111111111111111111111111111111111111111111111111111111
1E0PC0000C00000C00C00C0000000000011010010100100000101001000000010101
10100101001000001010010000000101011010010100100000101001000000010101
10100100101010100010010000000101000010010100100000101001000000010101
100000000C00C00000C0000000000000C11010010100100000101001000000010101
10100101001000001010010000000101011010010100100000101001000000010101
10100100101010100010010000000101000010010100100000101001000000010101
100000000C00C00000C0000000000000C11010010100100000101001000000010101
10100101001000001010010000000101000010010100100000101001000000010101
10100100101010100010010000000101011010010100100000101001000000010101
100000000C00C00000C0000000000000C00010010100100000101001000000010101
11111111111111111111111111111111111010010100100000101001000000010101
10100100101010100010010000000101000010010100100000101001000000010101
100000000C00C00000C0000000000000C11010010100100000101001000000010101
10100101001000001010010000000101000010010100100000101001000000010101
10100100101010100010010000000101011010010100100000101001000000010101
100000000C00C00000C0000000000000C00010010100100000101001000000010101
11111111111111111111111111111111111111111111111111111111111111111111